######################################################################################################################################
#....................................................................................................................................#
#....................................................................................................................................#
#....................................................................................................................................#
#....................................................................................................................................#
#....................................................................................................................................#
#....................................................................................................................................#
#....................................................................................................................................#
#....................................................................................................................................#
#....................................................................................................................................#
#....................................................................................................................................#
#....................................................................................................................................#
#....................................................................................................................................#
#....................................................................................................................................#
#....................................................................................................................................#
#.......................................................................########.....................................................#
#.......................................................................#......#.....................................................#
#.......................................................................#......#.....................................................#
#.......................................................................#......#.....................................................#
#....................................................@..................###..###.....................................................#
#....................................................................................................................................#
#....................................................................................................................................#
#....................................................................................................................................#
#....................................................................................................................................#
#....................................................................................................................................#
#....................................................................................................................................#
#....................................................................................................................................#
#....................................................................................................................................#
#....................................................................................................................................#
#....................................................................................................................................#
#....................................................................................................................................#
#....................................................................................................................................#
#....................................................................................................................................#
#....................................................................................................................................#
#....................................................................................................................................#
#....................................................................................................................................#
#....................................................................................................................................#
#....................................................................................................................................#
#....................................................................................................................................#
#....................................................................................................................................#
#....................................................................................................................................#
#....................................................................................................................................#
#....................................................................................................................................#
#....................................................................................................................................#
#....................................................................................................................................#
######################################################################################################################################