################################################################################################
#..............................................................................................#
#..............................................................................................#
#..............................................................................................#
#..............................................................................................#
#..............................................................................................#
#..............................................................................................#
#..............................................................................................#
#..............................................................................................#
#..............................................................................................#
#..............................................................................................#
#..............................................................................................#
#..............................................................................................#
#..............................................................................................#
#...............................................########.......................................#
#...............................................#......#.......................................#
#...............................................#......#.......................................#
#...............................................#......#.......................................#
#............................@..................###..###.......................................#
#..............................................................................................#
#..............................................................................................#
#..............................................................................................#
#..............................................................................................#
#..............................................................................................#
#..............................................................................................#
#..............................................................................................#
#..............................................................................................#
#..............................................................................................#
#..............................................................................................#
#..............................................................................................#
#..............................................................................................#
#..............................................................................................#
#..............................................................................................#
#..............................................................................................#
#..............................................................................................#
################################################################################################
